ASSIGNMENT 0 : RLI_09_00 

GROUP 0 : ASWIN SUBRAMANIAN MAHESWARAN, AYA-YASMINE BELLOUM, DANIEL RÖSEL
GROUP 1 : ALBERTO PULIGA, MAKENNA MARIE WARNER, JASKARAN SINGH GHAI
GROUP 2 : EVAN COLE WELSH, THULFIQAR KHALEEL ABED AL-SHAHEEB, SHAHAF BRENNER
GROUP 3 : WESSAM MADKHANA, MATHIAS ALEXANDER ZMUDA, TRINIDAD ROCA
GROUP 4 : INDIA LUCÍA ANTÚNEZ SÁNCHEZ, TALINE FAHED H. SHAWWA, KYE ELECTRICITEH
GROUP 5 : PAUL, LOUIS, VINCENT, JUAN DE RUIZ--ALLIATA, VICTOR BELLENS, SERGIO VERDUGO RUBIO
GROUP 6 : JUAN DIEGO FERNÁNDEZ ARAUJO, GREGORIO GIUSEPPE ORLANDO, LARBI BENAMOUR
GROUP 7 : ADRIÁN DE LA TORRE BLÁZQUEZ, TOMÁS MESALLES MEJÍA, NOAH VALDERRAMA HERNANDO
GROUP 8 : PIETRO RODRIGANO ABRIL, DIANA RUBAGA, JOSÉ MIGUEL SERRANO FLORES
GROUP 9 : ANTHONY-LEE SANCHEZ, BAPTISTE ETROY, HUSEYIN EMIR BAYRAK
GROUP 10 : FYNN LUKAS FRÜHLING, PEDRO TORRADO AGUILAR CAUZ, DANIEL KEN KUMLIN
GROUP 11 : RONALD SEBASTIÁN BELTRÁN NÚÑEZ, CELINE KHALED FAWWAZ ALZOU´BI, ANNA KATHLEEN PAYNE

THULFIQAR KHALEEL ABED AL-SHAHEEB : GROUP 2 WITH EVAN COLE WELSH, SHAHAF BRENNER
CELINE KHALED FAWWAZ ALZOU´BI : GROUP 11 WITH RONALD SEBASTIÁN BELTRÁN NÚÑEZ, ANNA KATHLEEN PAYNE
INDIA LUCÍA ANTÚNEZ SÁNCHEZ : GROUP 4 WITH TALINE FAHED H. SHAWWA, KYE ELECTRICITEH
HUSEYIN EMIR BAYRAK : GROUP 9 WITH ANTHONY-LEE SANCHEZ, BAPTISTE ETROY
VICTOR BELLENS : GROUP 5 WITH PAUL, LOUIS, VINCENT, JUAN DE RUIZ--ALLIATA, SERGIO VERDUGO RUBIO
AYA-YASMINE BELLOUM : GROUP 0 WITH ASWIN SUBRAMANIAN MAHESWARAN, DANIEL RÖSEL
RONALD SEBASTIÁN BELTRÁN NÚÑEZ : GROUP 11 WITH CELINE KHALED FAWWAZ ALZOU´BI, ANNA KATHLEEN PAYNE
LARBI BENAMOUR : GROUP 6 WITH JUAN DIEGO FERNÁNDEZ ARAUJO, GREGORIO GIUSEPPE ORLANDO
SHAHAF BRENNER : GROUP 2 WITH EVAN COLE WELSH, THULFIQAR KHALEEL ABED AL-SHAHEEB
ADRIÁN DE LA TORRE BLÁZQUEZ : GROUP 7 WITH TOMÁS MESALLES MEJÍA, NOAH VALDERRAMA HERNANDO
KYE ELECTRICITEH : GROUP 4 WITH INDIA LUCÍA ANTÚNEZ SÁNCHEZ, TALINE FAHED H. SHAWWA
BAPTISTE ETROY : GROUP 9 WITH ANTHONY-LEE SANCHEZ, HUSEYIN EMIR BAYRAK
JUAN DIEGO FERNÁNDEZ ARAUJO : GROUP 6 WITH GREGORIO GIUSEPPE ORLANDO, LARBI BENAMOUR
FYNN LUKAS FRÜHLING : GROUP 10 WITH PEDRO TORRADO AGUILAR CAUZ, DANIEL KEN KUMLIN
JASKARAN SINGH GHAI : GROUP 1 WITH ALBERTO PULIGA, MAKENNA MARIE WARNER
DANIEL KEN KUMLIN : GROUP 10 WITH FYNN LUKAS FRÜHLING, PEDRO TORRADO AGUILAR CAUZ
WESSAM MADKHANA : GROUP 3 WITH MATHIAS ALEXANDER ZMUDA, TRINIDAD ROCA
TOMÁS MESALLES MEJÍA : GROUP 7 WITH ADRIÁN DE LA TORRE BLÁZQUEZ, NOAH VALDERRAMA HERNANDO
GREGORIO GIUSEPPE ORLANDO : GROUP 6 WITH JUAN DIEGO FERNÁNDEZ ARAUJO, LARBI BENAMOUR
ANNA KATHLEEN PAYNE : GROUP 11 WITH RONALD SEBASTIÁN BELTRÁN NÚÑEZ, CELINE KHALED FAWWAZ ALZOU´BI
ALBERTO PULIGA : GROUP 1 WITH MAKENNA MARIE WARNER, JASKARAN SINGH GHAI
TRINIDAD ROCA : GROUP 3 WITH WESSAM MADKHANA, MATHIAS ALEXANDER ZMUDA
PIETRO RODRIGANO ABRIL : GROUP 8 WITH DIANA RUBAGA, JOSÉ MIGUEL SERRANO FLORES
DANIEL RÖSEL : GROUP 0 WITH ASWIN SUBRAMANIAN MAHESWARAN, AYA-YASMINE BELLOUM
DIANA RUBAGA : GROUP 8 WITH PIETRO RODRIGANO ABRIL, JOSÉ MIGUEL SERRANO FLORES
PAUL, LOUIS, VINCENT, JUAN DE RUIZ--ALLIATA : GROUP 5 WITH VICTOR BELLENS, SERGIO VERDUGO RUBIO
ANTHONY-LEE SANCHEZ : GROUP 9 WITH BAPTISTE ETROY, HUSEYIN EMIR BAYRAK
JOSÉ MIGUEL SERRANO FLORES : GROUP 8 WITH PIETRO RODRIGANO ABRIL, DIANA RUBAGA
TALINE FAHED H. SHAWWA : GROUP 4 WITH INDIA LUCÍA ANTÚNEZ SÁNCHEZ, KYE ELECTRICITEH
ASWIN SUBRAMANIAN MAHESWARAN : GROUP 0 WITH AYA-YASMINE BELLOUM, DANIEL RÖSEL
PEDRO TORRADO AGUILAR CAUZ : GROUP 10 WITH FYNN LUKAS FRÜHLING, DANIEL KEN KUMLIN
NOAH VALDERRAMA HERNANDO : GROUP 7 WITH ADRIÁN DE LA TORRE BLÁZQUEZ, TOMÁS MESALLES MEJÍA
SERGIO VERDUGO RUBIO : GROUP 5 WITH PAUL, LOUIS, VINCENT, JUAN DE RUIZ--ALLIATA, VICTOR BELLENS
MAKENNA MARIE WARNER : GROUP 1 WITH ALBERTO PULIGA, JASKARAN SINGH GHAI
EVAN COLE WELSH : GROUP 2 WITH THULFIQAR KHALEEL ABED AL-SHAHEEB, SHAHAF BRENNER
MATHIAS ALEXANDER ZMUDA : GROUP 3 WITH WESSAM MADKHANA, TRINIDAD ROCA
