ASSIGNMENT 0 : RLI_09_00 

GROUP 0 : GLORIA PARASCHIVOIU, ANNA SHATS, JORGE VARGAS TIMÓN
GROUP 1 : ANDREI BARAITARU, ZAID SAAD NADEEM AL TAYAN, FARAH ORFALY
GROUP 2 : RODRIGO JESÚS SAGASTEGUI MARTÍNEZ, ANGEL LOPEZ TORRALBA, EDOUARD PIERRE WIDMAIER-RUIZ-PICASSO
GROUP 3 : LEONARDO CAMILLERI, SEBASTIAN PERILLA ESPINOSA, ALEXANDRA KHREICHE
GROUP 4 : DAVID OREOLUWA AYOMIDE ADEAKIN, <NOBODY>, JA´FAR MOHAMMED AHMAD OBEIDAT
GROUP 5 : ZAID KHALED (AHMAD FAWZI) ALSAHEB, GUY MAZAR, ILARIA PAPILLO
GROUP 6 : PÉTER NORBERT KARACS, ELS ALEKSANDRA VAKS, DANIEL ARTURO MORA SOLER
GROUP 7 : CLARA MOUZANNAR, SALEH HASSAN IBRAHIM HASSAN ABD ELRAHMAN, JOSE ANTONIO IZARRA MILLAN
GROUP 8 : ANDRÉS JOSÉ TABOADA SANTAMARÍA, KARL MOUCHANTAF, DANIEL MARCOS SÁNCHEZ VELILLA
GROUP 9 : SOFÍA VITORICA NOGUES, ISMAEL PICAZO FLORES, LAURA PATRICIA CUELLAR CAMACHO
GROUP 10 : MASSIMO GIUSEPPE RIDELLA, LUIS GÓMEZ-ACEBO MARTÍN-RETORTILLO, RICARDO ANDRÉS MENDEZ CAVALIERI

SALEH HASSAN IBRAHIM HASSAN ABD ELRAHMAN : GROUP 7 WITH CLARA MOUZANNAR, JOSE ANTONIO IZARRA MILLAN
DAVID OREOLUWA AYOMIDE ADEAKIN : GROUP 4 WITH <NOBODY>, JA´FAR MOHAMMED AHMAD OBEIDAT
ZAID KHALED (AHMAD FAWZI) ALSAHEB : GROUP 5 WITH GUY MAZAR, ILARIA PAPILLO
ZAID SAAD NADEEM AL TAYAN : GROUP 1 WITH ANDREI BARAITARU, FARAH ORFALY
ANDREI BARAITARU : GROUP 1 WITH ZAID SAAD NADEEM AL TAYAN, FARAH ORFALY
LEONARDO CAMILLERI : GROUP 3 WITH SEBASTIAN PERILLA ESPINOSA, ALEXANDRA KHREICHE
LAURA PATRICIA CUELLAR CAMACHO : GROUP 9 WITH SOFÍA VITORICA NOGUES, ISMAEL PICAZO FLORES
LUIS GÓMEZ-ACEBO MARTÍN-RETORTILLO : GROUP 10 WITH MASSIMO GIUSEPPE RIDELLA, RICARDO ANDRÉS MENDEZ CAVALIERI
JOSE ANTONIO IZARRA MILLAN : GROUP 7 WITH CLARA MOUZANNAR, SALEH HASSAN IBRAHIM HASSAN ABD ELRAHMAN
PÉTER NORBERT KARACS : GROUP 6 WITH ELS ALEKSANDRA VAKS, DANIEL ARTURO MORA SOLER
ALEXANDRA KHREICHE : GROUP 3 WITH LEONARDO CAMILLERI, SEBASTIAN PERILLA ESPINOSA
ANGEL LOPEZ TORRALBA : GROUP 2 WITH RODRIGO JESÚS SAGASTEGUI MARTÍNEZ, EDOUARD PIERRE WIDMAIER-RUIZ-PICASSO
GUY MAZAR : GROUP 5 WITH ZAID KHALED (AHMAD FAWZI) ALSAHEB, ILARIA PAPILLO
RICARDO ANDRÉS MENDEZ CAVALIERI : GROUP 10 WITH MASSIMO GIUSEPPE RIDELLA, LUIS GÓMEZ-ACEBO MARTÍN-RETORTILLO
DANIEL ARTURO MORA SOLER : GROUP 6 WITH PÉTER NORBERT KARACS, ELS ALEKSANDRA VAKS
KARL MOUCHANTAF : GROUP 8 WITH ANDRÉS JOSÉ TABOADA SANTAMARÍA, DANIEL MARCOS SÁNCHEZ VELILLA
CLARA MOUZANNAR : GROUP 7 WITH SALEH HASSAN IBRAHIM HASSAN ABD ELRAHMAN, JOSE ANTONIO IZARRA MILLAN
JA´FAR MOHAMMED AHMAD OBEIDAT : GROUP 4 WITH DAVID OREOLUWA AYOMIDE ADEAKIN, <NOBODY>
FARAH ORFALY : GROUP 1 WITH ANDREI BARAITARU, ZAID SAAD NADEEM AL TAYAN
ILARIA PAPILLO : GROUP 5 WITH ZAID KHALED (AHMAD FAWZI) ALSAHEB, GUY MAZAR
GLORIA PARASCHIVOIU : GROUP 0 WITH ANNA SHATS, JORGE VARGAS TIMÓN
SEBASTIAN PERILLA ESPINOSA : GROUP 3 WITH LEONARDO CAMILLERI, ALEXANDRA KHREICHE
ISMAEL PICAZO FLORES : GROUP 9 WITH SOFÍA VITORICA NOGUES, LAURA PATRICIA CUELLAR CAMACHO
MASSIMO GIUSEPPE RIDELLA : GROUP 10 WITH LUIS GÓMEZ-ACEBO MARTÍN-RETORTILLO, RICARDO ANDRÉS MENDEZ CAVALIERI
RODRIGO JESÚS SAGASTEGUI MARTÍNEZ : GROUP 2 WITH ANGEL LOPEZ TORRALBA, EDOUARD PIERRE WIDMAIER-RUIZ-PICASSO
DANIEL MARCOS SÁNCHEZ VELILLA : GROUP 8 WITH ANDRÉS JOSÉ TABOADA SANTAMARÍA, KARL MOUCHANTAF
ANNA SHATS : GROUP 0 WITH GLORIA PARASCHIVOIU, JORGE VARGAS TIMÓN
ANDRÉS JOSÉ TABOADA SANTAMARÍA : GROUP 8 WITH KARL MOUCHANTAF, DANIEL MARCOS SÁNCHEZ VELILLA
ELS ALEKSANDRA VAKS : GROUP 6 WITH PÉTER NORBERT KARACS, DANIEL ARTURO MORA SOLER
JORGE VARGAS TIMÓN : GROUP 0 WITH GLORIA PARASCHIVOIU, ANNA SHATS
SOFÍA VITORICA NOGUES : GROUP 9 WITH ISMAEL PICAZO FLORES, LAURA PATRICIA CUELLAR CAMACHO
EDOUARD PIERRE WIDMAIER-RUIZ-PICASSO : GROUP 2 WITH RODRIGO JESÚS SAGASTEGUI MARTÍNEZ, ANGEL LOPEZ TORRALBA
<NOBODY> : GROUP 4 WITH DAVID OREOLUWA AYOMIDE ADEAKIN, JA´FAR MOHAMMED AHMAD OBEIDAT
